You are in the CW.  However, the air mattress is out of place.  Please put it back where it belongs, the one-windowed room.

World State Monitor
An Interactive Fiction by Andrew Dougherty
Release 1 / Serial number 140825 / Inform 7 build 6L02 (I6/v6.33 lib 6/12N) SD

computer room
A small room filled with computers.

You can see a fan, an air filter and Andrew here.

>l
Gallery

>w
You can't go that way.

>ne
You can't go that way.

>nw
You can't go that way.

>s
main room

>nw
You can't go that way.

>ne
couch room

>ne
bathroom

>w
You can't go that way.

>e
You can't go that way.

>sw
couch room

>sw
main room

>s
inside hallway

>w
one-window room

>e
inside hallway

>s
You can't go that way.

>sw
You can't go that way.

>se
southern entrance room

>sw
kitchen

>ne
southern entrance room

>s
windowed room

>n
southern entrance room

* * *

You are in the CW.  However, the air mattress is out of place.  Please put it back where it belongs, the one-windowed room.

World State Monitor
An Interactive Fiction by Andrew Dougherty
Release 1 / Serial number 140825 / Inform 7 build 6L02 (I6/v6.33 lib 6/12N) SD

computer room
A small room filled with computers.

You can see a fan, an air filter and Andrew here.

>Where is the air mattress/
That's not a verb I recognise.

>Where is the air mattress?
That's not a verb I recognise.

* * *

You are in the CW.  However, the air mattress is out of place.  Please put it back where it belongs, the one-windowed room.

World State Monitor
An Interactive Fiction by Andrew Dougherty
Release 1 / Serial number 140825 / Inform 7 build 6L02 (I6/v6.33 lib 6/12N) SD

computer room
A small room filled with computers.

You can see a fan, an air filter and Andrew here.

>take the mattress.
Taken.

>go to the one-window room
You can't see any such thing.

>l
Gallery

>s
main room

>sw
You can't go that way.

>s
inside hallway

>sw
You can't go that way.

* * *

>ne
southern entrance room

>nw
inside hallway

>w
one-window room

>put down air mattress
Dropped.

>Where is the air mattress?
That's not a verb I recognise.

>Where does the air mattress belong?
That's not a verb I recognise.

>l
one-window room
You can see an air mattress here.

* * *

>take the mattress.
Taken.

>s
You can't go that way.

* * *

>sw
You can't go that way.

>se
triangular area

>s
main area

>sw
one-windowed room

>drop the mattress
    *** Good job. ***

Would you like to RESTART, RESTORE a saved game, QUIT or UNDO the last command?

* * *

You are in the CW.  However, the air mattress is out of place.  Please put it back where it belongs, the one-windowed room.

World State Monitor
An Interactive Fiction by Andrew Dougherty
Release 1 / Serial number 140825 / Inform 7 build 6L02 (I6/v6.33 lib 6/12N) SD

computer room
A small room filled with computers.

You can see a fan, an air filter and Andrew here.

>x plain white desks
You see nothing special about five plain white desks.

* * *

You are in the CW.  However, the air mattress is out of place.  Please put it back where it belongs, the one-windowed room.

World State Monitor
An Interactive Fiction by Andrew Dougherty
Release 1 / Serial number 140825 / Inform 7 build 6L02 (I6/v6.33 lib 6/12N) SD

computer room
A small room filled with computers.

You can see a fan, an air filter and Andrew here.

>x desks
You see nothing special about 5 plain white desks.

* * *

You are in the CW.  However, the air mattress is out of place.  Please put it back where it belongs, the one-windowed room.

World State Monitor
An Interactive Fiction by Andrew Dougherty
Release 1 / Serial number 140825 / Inform 7 build 6L02 (I6/v6.33 lib 6/12N) SD

computer room
A small room filled with computers.

You can see a fan, an air filter and Andrew here.

>take air mattress.
Taken.

>s
You can't go that way.

>se
triangular area

* * *

>s
main area

>w
You can't go that way.

>e
Chuck's room

>w
main area

>s
You can't go that way.

>sw
one-windowed room

* * *

You are in the CW.  However, the air mattress is out of place.  Please put it back where it belongs, the one-windowed room.

World State Monitor
An Interactive Fiction by Andrew Dougherty
Release 1 / Serial number 140825 / Inform 7 build 6L02 (I6/v6.33 lib 6/12N) SD

computer room
A small room filled with computers.

You can see a fan, an air filter and Andrew here.

>nw
You can't go that way.

>se
triangular area

>l
triangular area

>nw
gallery
A larger white room.

You can see a free shelf, a bookshelf, a printer table, a western window, a mid-western window, a mid-eastern window, an eastern window and an air mattress here.

>get the mattress
Taken.

>i
You are carrying:
  an air mattress

>l
gallery
A larger white room.

You can see a free shelf, a bookshelf, a printer table, a western window, a mid-western window, a mid-eastern window and an eastern window here.

>ne
You can't go that way.

>se
triangular area

>nw
gallery
A larger white room.

You can see a free shelf, a bookshelf, a printer table, a western window, a mid-western window, a mid-eastern window and an eastern window here.

>se
triangular area

>ne
couch area

>sw
triangular area

>s
main area

* * *

>sw
one-windowed room

>drop matress
You can't see any such thing.

>drop the air matress
I only understood you as far as wanting to drop the air mattress.

>drop the air mattress
Dropped.

>i
You are carrying nothing.

* * *

You are in the CW.  However, the air mattress is out of place.  Please put it back where it belongs, the one-windowed room.

World State Monitor
An Interactive Fiction by Andrew Dougherty
Release 1 / Serial number 140825 / Inform 7 build 6L02 (I6/v6.33 lib 6/12N) SD

computer room
A small room filled with computers.

You can see a fan, an air filter and Andrew here.

>go n
You can't go that way.

>go south
You can't go that way.

>go right
You can't see any such thing.

>go east
You can't go that way.

>go wst
You can't see any such thing.

>go weat
You can't see any such thing.

>go weast
You can't see any such thing.

>go west
You can't go that way.

>where does the air mattress belong?
That's not a verb I recognise.

* * *

You are in the CW.  However, the air mattress is out of place.  Please put it back where it belongs, the one-windowed room.

World State Monitor
An Interactive Fiction by Andrew Dougherty
Release 1 / Serial number 140825 / Inform 7 build 6L02 (I6/v6.33 lib 6/12N) SD

computer room
A small room filled with computers.

You can see a fan, an air filter and Andrew here.

>pick up
What do you want to pick up?

>air mattress
Taken.

>go
You'll have to say which compass direction to go in.

>go n
You can't go that way.

>go e
You can't go that way.

>go sw
You can't go that way.

>go se
triangular area

>go nw
gallery
A larger white room.

You can see a free shelf, a bookshelf, a printer table, a western window, a mid-western window, a mid-eastern window and an eastern window here.

>go nw
You can't go that way.

>go e
You can't go that way.

>go northeasr
You can't see any such thing.

>go northeast
You can't go that way.

>go se
triangular area

* * *

>go nw
gallery
A larger white room.

You can see a free shelf, a bookshelf, a printer table, a western window, a mid-western window, a mid-eastern window and an eastern window here.

>go sw
You can't go that way.

* * *

>go nw
gallery
A larger white room.

You can see a free shelf, a bookshelf, a printer table, a western window, a mid-western window, a mid-eastern window and an eastern window here.

>go ew
You can't see any such thing.

>go nne
You can't see any such thing.

>go down
You can't go that way.

>go up
You can't go that way.

>go downeast
You can't see any such thing.

>help
That's not a verb I recognise.

>gose
That's not a verb I recognise.

>go se
triangular area

>s
main area

* * *

>sw
one-windowed room

>put down
(the air mattress)

    *** Good job!  You have won! ***

Would you like to RESTART, RESTORE a saved game, QUIT or UNDO the last command?

* * *

You are in the CW.  However, the air mattress is out of place.  Please put it back where it belongs, the one-windowed room.

World State Monitor
An Interactive Fiction by Andrew Dougherty
Release 1 / Serial number 140825 / Inform 7 build 6L02 (I6/v6.33 lib 6/12N) SD

computer room
A small room filled with computers.

You can see a fan, an air filter and Andrew here.

>se
triangular area

>ne
couch area
A place where one can rest.

* * *

You are in the CW.  However, the air mattress is out of place.  Please put it back where it belongs, the one-windowed room.

World State Monitor
An Interactive Fiction by Andrew Dougherty
Release 1 / Serial number 140825 / Inform 7 build 6L02 (I6/v6.33 lib 6/12N) SD

computer room
A small room filled with computers.

You can see a fan, an air filter and Andrew here.

>sw
You can't go that way.

>se
triangular area
A triangular shaped area connecting three other areas.

>s
main area

* * *

>w
main area

>sw
one-windowed room
A triangular shaped room.

>ne
main area

>n
triangular area
A triangular shaped area connecting three other areas.

>nw
gallery
A larger white room.

You can see a free shelf, a bookshelf, a printer table, a western window, a mid-western window, a mid-eastern window, an eastern window and an air mattress here.

>take mattress.
Taken.

>sw
You can't go that way.

* * *

>s
main area

>sw
one-windowed room
A triangular shaped room.

>drop mattress.
    *** Good job!  You have won! ***

Would you like to RESTART, RESTORE a saved game, QUIT or UNDO the last command?

* * *

You are in the CW.  However, the air mattress is out of place.  Please put it back where it belongs, the one-windowed room.

World State Monitor
An Interactive Fiction by Andrew Dougherty
Release 1 / Serial number 140825 / Inform 7 build 6L02 (I6/v6.33 lib 6/12N) SD

computer room
A small room filled with computers.

You can see a fan, an air filter and Andrew here.

>turn off the fan
You switch the fan off.

>turn off the air filter
You switch the air filter off.

* * *

You are in the CW.  However, the air mattress is out of place.  Please put it back where it belongs, the one-windowed room.

World State Monitor
An Interactive Fiction by Andrew Dougherty
Release 1 / Serial number 140825 / Inform 7 build 6L02 (I6/v6.33 lib 6/12N) SD

computer room
A small room filled with computers.

You can see a fan, an air filter and Andrew here.

>s
You can't go that way.

>n
You can't go that way.

>e
You can't go that way.

>w
You can't go that way.